8
1
0 4
15 15
0 0 0 0 0 - - - - - 0 0 0 0 0
0 7 8 1 0 - - c - - 0 7 8 1 0
0 6 - 2 0 - - x - - 0 6 - 2 0
0 5 4 3 0 - - x - - 0 5 4 3 0
0 0 0 0 0 - - - - - 0 0 0 0 0
- - - - - 0 0 0 0 0 - - - - -
- - - - - 0 7 8 1 0 - - - - -
- c x x - 0 6 - 2 0 - x x c -
- - - - - 0 5 4 3 0 - - - - -
- - - - - 0 0 0 0 0 - - - - -
0 0 0 0 0 - - - - - 0 0 0 0 0
0 7 8 1 0 - - x - - 0 7 8 1 0
0 6 - 2 0 - - x - - 0 6 - 2 0
0 5 4 3 0 - - c - - 0 5 4 3 0
0 0 0 0 0 - - - - - 0 0 0 0 0
4 0 2 <-> 10 0 6
4 1 2 <-> 10 1 6
13 4 4 <-> 13 10 0
14 4 4 <-> 14 10 0
10 13 6 <-> 4 13 2
10 14 6 <-> 4 13 2
1 10 0 <-> 1 4 6
0 10 0 <-> 0 4 6
3 4 4 <-> 5 6 6
4 3 2 <-> 6 5 0
11 4 4 <-> 9 6 2
10 3 6 <-> 8 5 0
11 10 0 <-> 9 8 2
10 11 6 <-> 8 9 4
3 10 0 <-> 5 8 6
4 11 2 <-> 8 9 4