3
5
4 1
21 20
x 0 0 0 0 0 0 x - - - - - - - - - x x -
x 0 b 0 x 0 0 0 - - 0 0 x 0 b - - 0 0 -
- - - - - - x x - - 0 0 x 0 0 - - 0 x -
- - - - - - 0 0 2 1 0 0 - 0 x - - 0 0 -
- - - - - - b 0 1 2 0 0 - 0 0 - - x 0 -
- - - - - - - - - - - - - x 0 - - 0 0 -
- - - - - - - - - - - - - 0 0 - - x x -
- - - 0 0 b 0 x 0 0 0 0 0 x x - - x x -
- - - 0 0 0 0 0 0 x 0 0 0 x x - - 0 0 -
- 0 0 x x - - - - - - - - - - - - 0 b -
- 0 0 x x - 0 0 2 3 0 x - x x 0 0 0 0 -
- 0 0 - - - 0 0 3 2 0 0 - x x 0 0 0 x -
- x x 0 b 0 x x - - 0 0 - 0 0 - - - - -
- x x 0 0 0 x x - - x 0 - 0 b - - - - -
- - - - - - - - - - 0 0 - x 0 - - - - -
- - - - - - - - - - x 0 - 0 0 3 1 0 0 x
- - x x 0 0 0 0 b 0 0 0 - 0 0 1 3 0 0 0
- - x x 0 0 0 0 0 0 0 x - - - - - - x x
- - 0 0 - - - - - - - - - - - - - - x x
- - 0 b 0 x 0 0 0 x x 0 0 0 x 0 0 0 0 0
- - x 0 0 0 0 b 0 x x 0 b 0 0 0 x 0 0 b
0 0 6 <-> 17 0 0
0 1 6 <-> 18 0 0
- - 0 0 0 0 0 0 0 0 0 0 0 0 0 0 0 0 0 0