2
6
3 2
24 32
- - - - - - - - - - - - - - - - - - - - - - - - - - - - - - - -
- - - - - - - - - - - - - - - - - - - - - - - - - - - - - - - -
- - - - - - - - - - - - - - - - - - - - - - - - - - - - - - - -
- - - - - - - - - - - - - - - - - - - - - - - - - - - - - - - -
- - - - - - - - - - - i 0 0 0 0 0 0 0 0 c - - - - - - - - - - -
- - - - - - - - - - - 0 0 0 0 0 0 0 0 0 0 - - - - - - - - - - -
- - - - - - - - - - - 0 0 0 1 2 2 1 0 0 0 - - - - - - - - - - -
- - - - - - - - - - - 0 0 0 2 1 1 2 0 0 0 - - - - - - - - - - -
- - - - - - - - - - - 0 0 0 0 0 0 0 0 0 0 - - - - - - - - - - -
- - - - - - - - - - - c 0 0 0 0 0 0 0 0 i - - - - - - - - - - -
- - - - - - - - - - - - - - - - - - - - - - - - - - - - - - - -
- - - - - - - - - - - - - - - - - - - - - - - - - - - - - - - -
- - - - - - - - - - - - - - - - - - - - - - - - - - - - - - - -
- - - - - - - - - - - - - - - - - - - - - - - - - - - - - - - -
- - c 0 0 0 0 0 0 0 0 i - - - - - - - - c 0 0 0 0 0 0 0 0 i - -
- - 0 0 0 1 0 2 0 1 0 0 - - - - - - - - 0 0 0 2 0 1 0 2 0 0 - -
- - 0 0 0 0 0 2 0 0 0 0 - - - - - - - - 0 0 0 2 0 0 0 1 0 0 - -
- - 0 0 0 0 0 0 0 0 0 0 - - - - - - - - 0 0 0 2 0 0 0 1 0 0 - -
- - 0 0 0 0 0 0 0 0 0 0 - - - - - - - - 0 0 0 0 0 0 0 0 0 0 - -
- - i 0 0 0 0 0 0 0 0 c - - - - - - - - i 0 0 0 0 0 0 0 0 c - -
- - - - - - - - - - - - - - - - - - - - - - - - - - - - - - - -
- - - - - - - - - - - - - - - - - - - - - - - - - - - - - - - -
- - - - - - - - - - - - - - - - - - - - - - - - - - - - - - - -
- - - - - - - - - - - - - - - - - - - - - - - - - - - - - - - -
11 14 1 <-> 11 9 4
20 14 7 <-> 20 9 4       
