2
5
4 3
27 31
- - - - - - - - - - - - - - - - - - - - - - - - - - - - - - -
- - - - - - - - - - - - - - - - - - - - - - - - - - - - - - -
- - - - - - - - - - - - - - - - - - - - - - - - - - - - - - -
- - - - - - - - - - - - - - - - - - - - - - - - - - - - - - -
- - - - - 0 0 0 0 0 0 0 0 0 0 0 0 0 0 0 0 0 0 0 0 0 - - - - -
- - - - - i 0 0 0 0 0 0 0 0 2 1 2 0 0 0 0 0 0 0 0 i - - - - -
- - - - - 0 0 0 0 0 0 0 0 0 0 0 0 0 0 0 0 0 0 0 0 0 - - - - -
- - - - - - - - - - - - - - - - - - - - - - - - - - - - - - -
- - - - - - - - - - - - - - - - - - - - - - - - - - - - - - -
- - - - - - - - - c 0 0 0 0 0 1 0 0 0 0 0 c - - - - - - - - -
- - - - - - - - - 0 0 0 0 0 0 0 0 0 0 0 0 0 - - - - - - - - -
- - - - - - - - - 0 0 0 0 0 0 0 0 0 0 0 0 0 - - - - - - - - -
- - - - - - - - - 1 0 0 0 0 2 1 2 0 0 0 0 2 - - - - - - - - -
- - - - - - - - - 1 0 0 0 0 1 2 1 0 0 0 0 2 - - - - - - - - -
- - - - - - - - - 0 0 0 0 0 0 0 0 0 0 0 0 0 - - - - - - - - -
- - - - - - - - - 0 0 0 0 0 0 0 0 0 0 0 0 0 - - - - - - - - -
- - - - - - - - - 0 0 0 0 0 0 0 0 0 0 0 0 0 - - - - - - - - -
- - - - - - - - - c 0 0 0 0 0 2 0 0 0 0 0 c - - - - - - - - -
- - - - - - - - - - - - - - - - - - - - - - - - - - - - - - -
- - - - - - - - - - - - - - - - - - - - - - - - - - - - - - -
- - - - - 0 0 0 0 0 0 0 0 0 0 0 0 0 0 0 0 0 0 0 0 0 - - - - -
- - - - - i 0 0 0 0 0 0 0 0 1 2 1 0 0 0 0 0 0 0 0 i - - - - -
- - - - - 0 0 0 0 0 0 0 0 0 0 0 0 0 0 0 0 0 0 0 0 0 - - - - -
- - - - - - - - - - - - - - - - - - - - - - - - - - - - - - -
- - - - - - - - - - - - - - - - - - - - - - - - - - - - - - -
- - - - - - - - - - - - - - - - - - - - - - - - - - - - - - -
- - - - - - - - - - - - - - - - - - - - - - - - - - - - - - -
9 4 0 <-> 9 6 4
10 4 0 <-> 10 6 4
11 4 0 <-> 11 6 4
12 4 0 <-> 12 6 4
13 4 0 <-> 13 6 4
14 4 0 <-> 14 6 4
15 4 0 <-> 15 6 4
16 4 0 <-> 16 6 4
17 4 0 <-> 17 6 4
18 4 0 <-> 18 6 4
19 4 0 <-> 19 6 4
20 4 0 <-> 20 6 4
21 4 0 <-> 21 6 4
9 20 0 <-> 9 22 4
10 20 0 <-> 10 22 4
11 20 0 <-> 11 22 4
12 20 0 <-> 12 22 4
13 20 0 <-> 13 22 4
14 20 0 <-> 14 22 4
15 20 0 <-> 15 22 4
16 20 0 <-> 16 22 4
17 20 0 <-> 17 22 4
18 20 0 <-> 18 22 4
19 20 0 <-> 19 22 4
20 20 0 <-> 20 22 4
21 20 0 <-> 21 22 4
