2
5
4 3
27 31
- - - - - - - - - - - - - - - - - - - - - - - - - - - - - - -
- - - - - - - - - - - - - - - - - - - - - - - - - - - - - - -
- - - - - - - - - - - - - - - - - - - - - - - - - - - - - - -
- - - - - - - - - - - - - - - - - - - - - - - - - - - - - - -
- - - - - 0 0 0 0 0 0 0 0 0 0 0 0 0 0 0 0 0 0 0 0 0 - - - - -
- - - - - i 0 0 0 0 0 0 0 0 2 1 2 0 0 0 0 0 0 0 0 i - - - - -
- - - - - 0 0 0 0 0 0 0 0 0 0 0 0 0 0 0 0 0 0 0 0 0 - - - - -
- - - - - - - - - - - - - - - - - - - - - - - - - - - - - - -
- - - - - - - - - - - - - - - - - - - - - - - - - - - - - - -
- - - - - - - - - c 0 0 0 0 0 1 0 0 0 0 0 c - - - - - - - - -
- - - - - - - - - 0 0 0 0 0 0 0 0 0 0 0 0 0 - - - - - - - - -
- - - - - - - - - 0 0 0 0 0 0 0 0 0 0 0 0 0 - - - - - - - - -
- - - - - - - - - 1 0 0 0 0 2 1 2 0 0 0 0 2 - - - - - - - - -
- - - - - - - - - 1 0 0 0 0 1 2 1 0 0 0 0 2 - - - - - - - - -
- - - - - - - - - 0 0 0 0 0 0 0 0 0 0 0 0 0 - - - - - - - - -
- - - - - - - - - 0 0 0 0 0 0 0 0 0 0 0 0 0 - - - - - - - - -
- - - - - - - - - 0 0 0 0 0 0 0 0 0 0 0 0 0 - - - - - - - - -
- - - - - - - - - c 0 0 0 0 0 2 0 0 0 0 0 c - - - - - - - - -
- - - - - - - - - - - - - - - - - - - - - - - - - - - - - - -
- - - - - - - - - - - - - - - - - - - - - - - - - - - - - - -
- - - - - 0 0 0 0 0 0 0 0 0 0 0 0 0 0 0 0 0 0 0 0 0 - - - - -
- - - - - i 0 0 0 0 0 0 0 0 1 2 1 0 0 0 0 0 0 0 0 i - - - - -
- - - - - 0 0 0 0 0 0 0 0 0 0 0 0 0 0 0 0 0 0 0 0 0 - - - - -
- - - - - - - - - - - - - - - - - - - - - - - - - - - - - - -
- - - - - - - - - - - - - - - - - - - - - - - - - - - - - - -
- - - - - - - - - - - - - - - - - - - - - - - - - - - - - - -
- - - - - - - - - - - - - - - - - - - - - - - - - - - - - - -
9 7 0 <-> 9 4 4
10 7 0 <-> 10 4 4
11 7 0 <-> 11 4 4
12 7 0 <-> 12 4 4
13 7 0 <-> 13 4 4
14 7 0 <-> 14 4 4
15 7 0 <-> 15 4 4
16 7 0 <-> 16 4 4
17 7 0 <-> 17 4 4
18 7 0 <-> 18 4 4
19 7 0 <-> 19 4 4
20 7 0 <-> 20 4 4
21 7 0 <-> 21 4 4
9 18 0 <-> 9 15 4
10 18 0 <-> 10 15 4
11 18 0 <-> 11 15 4
12 18 0 <-> 12 15 4
13 18 0 <-> 13 15 4
14 18 0 <-> 14 15 4
15 18 0 <-> 15 15 4
16 18 0 <-> 16 15 4
17 18 0 <-> 17 15 4
18 18 0 <-> 18 15 4
19 18 0 <-> 19 15 4
20 18 0 <-> 20 15 4
21 18 0 <-> 21 15 4