2
4
5 3
26 31
- - - - - - - - - - - - - - - - - - - - - - - - - - - - - - -
- - - - - - - - - - - - - - - - - - - - - - - - - - - - - - -
- - - - - - - - - - - - - - - - - - - - - - - - - - - - - - -
- - - - - - - - - - - - - - - - - - - - - - - - - - - - - - -
- - - - c 0 0 0 0 0 0 0 0 0 0 0 0 0 0 0 2 0 0 0 0 0 0 - - - -
- - - - 0 0 0 0 0 0 2 0 0 0 0 0 0 0 0 1 0 1 0 0 0 0 i - - - -
- - - - 0 0 0 0 0 0 1 0 0 0 0 0 0 0 0 2 0 2 0 0 0 0 0 - - - -
- - - - 0 0 0 0 0 0 2 0 0 0 0 0 0 0 0 0 1 0 0 0 0 0 0 - - - -
- - - - 0 0 0 1 2 1 1 2 0 0 0 - - - - - - - - - - - - - - - -
- - - - 0 0 0 0 1 0 0 0 0 0 0 - - - - - - - - - - - - - - - -
- - - - 0 0 0 0 2 0 0 0 0 0 0 - - - - - - - - - - - - - - - -
- - - - 0 0 0 0 1 0 0 0 0 0 0 - - - - - - - - - - - - - - - -
- - - - 0 0 0 0 0 0 0 0 0 0 0 - - - - - - - - - - - - - - - -
- - - - c 0 0 0 0 0 0 0 0 0 0 - - - - - - - - - - - - - - - -
- - - - - - - - - - - 0 0 0 0 0 0 0 0 0 0 0 0 0 0 0 0 - - - -
- - - - - - - - - - - 0 0 0 0 0 0 1 2 1 2 1 2 0 0 0 i - - - -
- - - - - - - - - - - 0 0 0 0 0 0 0 0 0 0 0 0 0 0 0 0 - - - -
- - - - 0 0 0 0 0 0 0 0 0 0 0 - - - - - - - - - - - - - - - -
- - - - 0 0 0 0 2 1 0 0 0 0 0 - - - - - - - - - - - - - - - -
- - - - 0 0 0 1 0 0 2 0 0 0 0 - - - - - - - - - - - - - - - -
- - - - 0 0 0 1 0 0 2 0 0 0 0 - - - - - - - - - - - - - - - -
- - - - i 0 0 0 2 1 0 0 0 0 0 - - - - - - - - - - - - - - - -
- - - - - - - - - - - - - - - - - - - - - - - - - - - - - - -
- - - - - - - - - - - - - - - - - - - - - - - - - - - - - - -
- - - - - - - - - - - - - - - - - - - - - - - - - - - - - - -
- - - - - - - - - - - - - - - - - - - - - - - - - - - - - - -
