2
5
0 0
18 16
0 0 0 - - - - - i i - - - - - 0 0 0
0 0 c 0 - - - - 0 0 - - - - 0 b 0 0
- 0 0 0 0 - - - 0 0 - - - 0 0 0 0 -
- - 0 0 0 0 - - 0 0 - - 0 0 0 0 - -
- - - 0 b 0 0 - 0 0 - 0 0 c 0 - - -
- - - - 0 0 0 0 0 0 0 0 0 0 - - - -
- - - - - 0 0 0 0 0 0 0 0 - - - - -
i 0 0 0 0 0 0 0 2 1 0 0 0 0 0 0 0 i
i 0 0 0 0 0 0 0 1 2 0 0 0 0 0 0 0 i
- - - - - 0 0 0 0 0 0 0 0 - - - - -
- - - - 0 0 0 0 0 0 0 0 0 0 - - - -
- - - 0 c 0 0 - 0 0 - 0 0 b 0 - - -
- - 0 0 0 0 - - 0 0 - - 0 0 0 0 - -
- 0 0 0 0 - - - 0 0 - - - 0 0 0 0 -
0 0 b 0 - - - - 0 0 - - - - 0 c 0 0
0 0 0 - - - - - i i - - - - - 0 0 0
8 0 0 <-> 8 15 4
9 0 0 <-> 9 15 4
0 7 6 <-> 18 7 2
0 8 6 <-> 18 8 2
0 1 7 <-> 15 15 3
0 0 7 <-> 16 15 3
1 0 7 <-> 17 15 3
2 0 7 <-> 17 14 3
15 0 1 <-> 0 14 5
16 0 1 <-> 0 15 5
17 0 1 <-> 1 15 5
17 1 1 <-> 2 15 5
